#V 4

#E 1 2 1
#E 2 4 1
#E 1 3 2
#E 3 2 5
#E 3 4 1
#V 2 P 3
#V 3 S
#V 4 P 1
#D 20